##########
#H.......#
#...##.###
#...##...#
########.#
#........#
#...#.#..#
#.###.#..#
E......M##
##########