#####E####
#####.####
###...#..#
##...##..#
##...##..#
##.....M.#
#...####.#
#.....##.#
#.H......#
##########