##########
#H.......#
#...#.#.##
#...#....#
#...#...##
#.......##
#...#...##
#..M#....E
#...#.#.##
##########