##########
#H...#####
#..###..##
#..####..#
#....#.#.#
#....###.#
#.######.#
#.######.E
#.......M#
##########