##########
#H.......#
#..#####.#
##.####..#
#.......##
#.#M#..###
#.....####
#####..###
#.......##
#E########